111111111111111111111111111111111
1P0000000000000010000000000000001
100011111111110001111111111100001
100010000000010000000000001000001
100010000C00011110000000100000001
100011110000000000000001000000001
100000010000011111000001000000001
100000010000010001000001000000001
100000010000011001000000000000001
111111010000000001000111111100001
100000010000000001000000000000001
100000000000000001111100000000001
100000001111111100000100000000001
111111111000000000000100000000001
100000000000000000000111111111111
100000001111111100000000000000001
100000000000000100000000000000001
111111111000000111111111100000001
100000001000000000000001100000001
100000000000000000000001100000001
1111111111111111111111111C0000E11
111111111111111111111111111111111
