1111111111111111111111111111
1P0000000000000000000C000001
100011111111111111100C111101
100000000000000000000C000001
100C000C111111111C111C111101
100C000000000000C00000000001
100111111111100C111111100001
100000000000C0000000000C0001
111110000000C000000000000001
1C00000001111111111111000001
1000000000000000000C000000E1
1111111111111111111111111111
