11111111111111111111111111111111111111111111111111
1P000000000000000000000001000000000000000000000001
10000000000000000000000001000000000000000000000001
10000111111111111110000001000000000000000000000001
100001C0000000000010000001000000000000000000000001
10000100000000000001000001000011111111111111100001
10000100000000000000100001000010000000000000100001
10000100001111111111100001000010000000000000100001
10000100001000000000000001000010000000000000100001
10000100001000000000000001000010000000000000100001
10000100001000000000000001000011111111111000100001
10000100001000000000000001000000000000001000100001
10000100001000000000000001111111100000001000100001
10000100001000000000E00000000000100000001000100001
10000100001000000000000000000000100000001000100001
100001C0000111111111111111111111000000010011110011
10000100000000000000000000000000000000000100000011
10000100000000000000000000000000000000000100000011
10000000000000000000000000000000000000000100000011
11111111111111111111111111111111111111111111111111
