111111111111111111111
1P0000001000000000001
111101101101111110111
1C00X000C000001000001
101101111011101110111
100000X000C0000010001
111011101110111011111
1C00000X00C00000000E1
111100000111101111111
111111111111111111111
