1111111111111111
1P00000000000001
1000111111111001
100000C000000001
1111101111110001
1C00000000000C01
1000111111111001
1000000000000001
1111000000111111
1000000000C00001
10000000000000E1
1111111111111111
