1111111111111111
1P00000000000001
1000000111100001
1000000000000001
1000000000000001
1000000000000001
1000000000000001
1000C00000000001
1111000000001111
1000000000000001
10000E0000000011
1111111111111111
